######
##SPA#
##WNH#
##ERE#
######
######
