#############
#    ## #   #
#    #    # #
#    #   #  #
# ## #   #  #
#    #  #   #
#        #  #
#############
