##############
##############
##SPA#      ##
##WNH#      ##
##ERE        #
###   ##  ####
### ##     ###
##    ########
##         X##
##############
##############