########################################################
##SPA  #  #      #######################################
##WNH        ##        #  ####     #  #      ###########
# ERE                              #  #      ###########
## ## # ####   ## ## ### #####     #  #      ###########
##    #     #  ##   ## #  ####           ##        # ###
## ###  ###  # #  #    ## ####                     # ###
## #   # ## ## # ##  # #                 ##        # ###
##   #              #     #### ###  ###  # #  #    ## ##
## ### ###### #######   ###### ###  ###  # #  #    ## ##
## ########    #  #    ## #### ###  ###  # #  #    ## ##
##     # ###    #  #    ## #### ###  ###  # #  #    ## #
####   ###### ###### #########    #     #  ##   ## #  ##
#### ######## #####  ##   #### ###  ###  # #  #    ## ##
#### ######## #####     #  ### ## # ####   ## ## ### ###
##     #  #      ######## ####    #     #  ##   ## #  ##
#            ##        #  ###    #     #  ##   ## #  ###
#                               #     #  ##   ## #    ##
## ## # ####   ## ## ######### #   # ## ## # ##  # #  ##
##    #     #  ##  ### #  #### #   # ## ## # ##  # #  ##
## ###  ###  # #  #    ####### ###  ###  # #  #    ## ##
## #   # ## ## # ##  # ##X####    #     #  ##   ## #  ##
##   #              #  #  #### ###  ###  # #  #    ## ##
############# ##########          #     #  ##   ## #  ##
########################################################