##################################################
#                                                #
#                                                #
# #       #####   #           #    #     ###     #
# #       #        #    #    #     #     #       #
# #       ###      #   # #   #     #      #      #
# #       #         # #   # #      #       #     #
# #####   #####      #     #       #     ###     #
#     HE                                         #
#     RE                                         #
##################################################