########################
#                      #
#     X   norst asdfa  #
#            bitsf     #
#      #         #     #
#                      #
#        #    #        #
#             #        #
#         #   #        #
#                      #
#        SPA           #
#        WNH           #
#        ERE           #
########################